...##########################################################
......#.....#........#..#..............#........#...........#
#..#######..#..####..#..#..#..#..#..#######..#..#..#..#..####
#........#..#..#.....#.....#..#..#..#..#.....#..#..#..#.....#
####..####..#..#..####..####..#..#..#..#..#..#..#..####..#..#
#..#.....#.....#........#.....#..#..#.....#..#........#..#..#
#..####..#..####..####..#..####..####..#############..#######
#..............#.....#..#..#.....#.....#.....#........#.....#
#..#..####..#######..####..####..####..#..#############..####
#..#.....#........#..#..#..#........#..............#........#
#..#..##########..####..####..#######..#..#..#..#######..#..#
#..#..#..#........#..#..#.....#........#..#..#.....#.....#..#
#..#..#..#..#..####..#..##########..######################..#
#..#..#.....#...........#..#..#.....#.....#........#........#
#..#############..#######..#..#..#..#..#..#..####..####..#..#
#..#.....#..#.....#........#.....#..#..#.....#.....#.....#..#
#..####..#..##########..##########..####..####..##########..#
#..#..#........#........#..#..#..#...........#..............#
#..#..#..#..####..#######..#..#..#..#..#..#######..#######..#
#.....#..#.....#........#...........#..#..#..#.....#........#
####..#..#..#######..####..#############..#..#..##########..#
#.....#..#..#..#..#........#..#........#..#..#.....#........#
#..#..#..####..#..#..#######..#..##########..####..####..####
#..#.....#.....#..#..#...........#.....#.....#.....#........#
#..#..#..#..#..#..##########..#..#..#######..####..#######..#
#..#..#.....#.................#.....#........#........#.....#
#######..#..####..#..##########..##########..#..#############
#..#.....#.....#..#..#.....#........#.....#.....#.....#.....#
#..#############..#..#..#..####..#..####..####..####..#..####
#...........#..#..#.....#.....#..#.....#.....#........#.....#
#..##########..#######..#..#######..#..#..#######..#..####..#
#........#..............#..#..#..#..#........#.....#........#
#..#######..#######..#..#..#..#..####..#..####..####..#######
#.....#........#..#..#..#.....#........#..#........#........#
#..#..#..#######..#..####..#..#..#######..####..#..#######..#
#..#........#..#.....#..#..#..#.....#..#........#........#..#
####..####..#..####..#..#######..####..#..#..####..####..####
#.....#..#..#..#........#.....#..#..#.....#.....#.....#..#..#
#..#..#..####..#######..#..#..####..#..#..#..####..#######..#
#..#........#..............#..#........#..#..#..............-
##########################################################---
