...#######
.........#
####..####
#........#
#..#..####
#..#.....-
#######---