...##########
.........#..#
####..#..#..#
#..#..#.....#
#..####..####
#........#..#
#..#..####..#
#..#........-
##########---