...################
.........#........#
#..#..##########..#
#..#..#...........#
#..####..#..#..####
#..#..#..#..#.....#
#..#..#..####..#..#
#........#..#..#..#
#..#..#..#..####..#
#..#..#.....#.....#
#..####..#######..#
#..#...........#..-
################---