...######################
......#........#........#
#..####..#..##########..#
#..#.....#.....#........#
#..#..####..##########..#
#.....#..#..#...........#
#######..#..####..#######
#.....#...........#.....#
#..####..####..#..#..#..#
#..#.....#..#..#.....#..#
#..#..####..####..#..#..#
#.....#...........#..#..#
####..#############..####
#.....#...........#.....#
#..#..#..####..#######..#
#..#........#..#........-
######################---