...############################
......#..............#.....#..#
####..#######..#######..####..#
#..#.....#.....#..............#
#..#..####..#..####..####..#..#
#..#..#.....#...........#..#..#
#..#..####..#..#..####..#######
#..#..#.....#..#.....#.....#..#
#..#..################..#..#..#
#..#.....#..#.....#.....#.....#
#..####..#..#..#############..#
#.................#.....#.....#
#..#######..##########..#..####
#..#........#..............#..#
#..######################..#..#
#.....#..#....................#
#..####..#..#..####..#..####..#
#........#..#..#..#..#.....#..#
#..####..####..#..#..#..####..#
#..#..............#..#.....#..-
############################---